F 0, 255, 255 
C 0, 255, 100

EA textures/poutou.xpm
NO textures/bardella.xpm
SO textures/melanch.xpm
WE textures/lassalle.xpm

1111
1W01
1111
