C 1,1,1
F 1,1,1
EA                                       textures/poutou.xpm
NO textures/bardella.xpm
SO textures/melanch.xpm
WE textures/lassalle.xpm
   111 
1111N1111
   111
