
GR textures/france.xpm
SK textures/ground.xpm

EA textures/poutou.xpm
NO textures/bardella.xpm
SO textures/melanch.xpm
WE textures/lassalle.xpm

  
11111111111111111111111111111111111111
10D00000011111110000000000000000000001
11111111D1000001111DD11111111111111001
1000000001000001000001000010000000D001
100000000100000D0000010010W10000001111
10000000010000010000010000000000001
11111111D11111110000010000000000001
     100010000010000011111111111111
   1110011000001000001
   110001000000D001DD1
   1000011111111111001            
   1000000000000000001
   1111111111111111111
