F 230, 198, 198
C 29, 29, 3

EA textures/matrix.xpm
NO textures/matrix.xpm
SO textures/matrix.xpm
WE textures/matrix.xpm

1111111111
1000001001
11110N0001
1000000001
1000111111
11111
11111
11101
10001
11111
