F  50    ,    255     , 10  
C 223, 23, 0

NO textures/matrix.xpm
SO textures/matrix.xpm
WE textures/matrix.xpm
EA textures/matrix.xpm

110111
100S01
100111
1001
1111