F 230, 198, 198
C 29, 29, 3

EA textures/matrix.xpm
NO textures/matrix.xpm
SO textures/matrix.xpm
WO textures/matrix.xpm
  
1111111111
1000001001
1111000001
100000N001
1000111111
10001
11101
10001
11111