F 255,255,255
C 60, 12, 159

EA textures/melanch.xpm
NO textures/melanch.xpm
SO textures/melanch.xpm
WE textures/melanch.xpm
  
11111111111111111111111111111111111
10000001000000000000000000000000001
11010000011111111000111111111111111
100001000111111110001
1000100001110000000011111
100000N001100111110110001
1111111011111111100011111
  1000000000000000001
  1111111111111111001
                 1001
                 1001
                 1001
                 1001
                 1001
                 1001
                 1001
                 1111