
GR textures/bardella.xpm
SK textures/hollande.xpm

EA textures/poutou.xpm
NO textures/bardella.xpm
SO textures/melanch.xpm
WE textures/hollande.xpm

  
11111111111111111111111111111111111
1000W001000000000000000000000000001
11110000011111111000111111111111111
100000000111111110001
111111100111000000001
     1100111111110001
  1111101111111110001
  1000000000000000001
  1111111111111111001
                 1001
                 1001
                 1001
                 1001
                 1001
                 1001
                 1001
                 1111






