
GR textures/bardella.xpm
SK textures/hollande.xpm

EA textures/poutou.xpm
NO textures/jsommet.xpm
SO textures/melanch.xpm
WE textures/hollande.xpm

  
111111111111
1111000001
1111000001
1111000001
1111000001
1111000001
1111E00001
1111000001111
1000001000001
1000001000001
1000001000001
1111111111111
