F 230, 198, 198
C 29, 29, 3

EA textures/matrix.xpm
NO textures/matrix.xpm
SO textures/matrix.xpm
WE textures/matrix.xpm
  
111111
1100N1
111111