F 230, 198, 198
C 29, 29, 3

EA textures/matrix.xpm
NO textures/matrix.xpm
SO textures/matrix.xpm
WE textures/matrix.xpm
  
11111111111111111111111111111111111
11000001000000000000000000000000001
11010000011111111000111111111111111
100000000111111110001
110011100111N11110001
     1100111111110001
  1111101111111110001
  1000000000000000001
  1111111111111111111