
GR textures/sky.xpm
SK textures/lea.xpm

EA textures/poutou.xpm
NO textures/bardella.xpm
SO textures/melanch.xpm
WE textures/hollande.xpm

  
11111111111111111111111111111111111
1000000D000000000000000000000000001
1111000W010011111000111111111111111
100000000010001110001
111111100001000000001
     1100111111D10001
  1111101111111010001
  1000000000000000001
  1111111111111111001
                 1001
                 1001
                 1001
                 1001
                 1001
                 1001
                 1001
                 1111






