
GR textures/poutou.xpm
SK textures/poutou.xpm
EA textures/poutou.xpm
NO textures/poutou.xpm
SO textures/poutou.xpm
WE textures/poutou.xpm

  
11111111111111111111111111111111111
1000000D000000000000000000000000001
11110000011111111000111111111111111
100000000111111110001
111111100111000S00001
     1100111111D10001
  1111101111111010001
  1000000000000000001
  1111111111111111001
                 1001
                 1001
                 1001
                 1001
                 1001
                 1001
                 1001
                 1111






