F 255,255,255
C 60, 12, 159

EA textures/matrix.xpm
NO textures/matrix.xpm
SO textures/matrix.xpm
WE textures/matrix.xpm
  
11111111111111111111111111111111111
10001001000000000000000000000000001
11S10000011111111000111111111111111
100000000111111110001
111111100111000000001
     1100111111110001
  1111101111111110001
  1000000000000000001
  1111111111111111001
                 1001
                 1001
                 1001
                 1001
                 1001
                 1001
                 1001
                 1111
