F 230, 198, 198
C 29, 29, 3

EA textures/matrix.xpm
NO textures/matrix.xpm
SO textures/matrix.xpm
WE textures/matrix.xpm
  
11111111111111111111111111111111111
10000010000000000000000000000000001
11110000011111111111111111111111111
100N000001
1000111111
11111
11101
10001
11111